#########
#S| | | #
#-#-#-#-#
# | | | #
#-#-#-#-#
# | | | #
#-#-#-#-#
# | | |V#
#########